1111111111111111111111111111111111111111
1300001000000000000000000000001000000031
1011101011111101111110111111101010111101
1010001010100000000000000000001010000101
1010101010101111011111111111101010110101
1010101010101010101010101010101010100101
1010100000000000000000000000000000101101
1010111101111111101111101111111110101101
1010100000000000000000000000000000100101
1010101101111011111111101111111110001101
1010101000000000000000000000000000100101
1010101010101001122211011111111110110101
1010111111111101222221000000000000000101
1010100000000001222221011111011111110101
1000001111111101222221000000000000000001
1010100000000001222221011111111011110101
1010101101010101111111000000000000000101
1010100101010100000000010101010101010101
1010101111011111011111110111011101110101
1010100000000000000000000000000000000101
1010101111011111101111111011111101110101
1010100000000000000000000000000000000101
1010101111110111111110111111111101110101
1010100000000000000000000000000000000101
1010101101111110111111111011111110110101
1010100000000000000000000000000000000101
1010000101010101010101010101010101010101
1011110101110101110101110101110101011101
1300000100000100000100000100000000000031
1111111111111111111111111111111111111111
